{
        "title": "Roundabout",
        "columns": 9,
        "rows": 7,
        "tiles": [
                0, 0, 0, 0, 0, 1, 0, 0, 0,
                0, 0, 0, 0, 0, 1, 1, 0, 0,
                0, 0, 0, 1, 1, 1, 1, 1, 0,
                0, 1, 1, 0, 0, 0, 1, 2, 1,
                1, 2, 1, 0, 0, 1, 2, 0, 1,
                1, 1, 1, 1, 1, 0, 0, 0, 0,
                0, 0, 0, 0, 1, 0, 0, 0, 0
        ],
        "entities": [
                0, 1, 4, 5,
                2, 2, 3, 0,
                2, 5, 1, 0,
                2, 6, 4, 0
        ]
}